15 19
0 3 3 3 3 3 3 3 3 3 3 3 3 3 3
3 6 3 6 3 6 3 6 3 6 3 6 3 6 3
3 3 5 5 3 3 3 3 3 3 3 2 3 3 3
3 6 5 6 3 6 3 6 3 6 3 6 3 6 3
3 3 5 3 3 2 3 2 5 5 5 5 3 3 3
3 6 3 6 3 6 3 6 5 6 3 6 3 6 3
2 2 2 2 3 3 3 3 5 2 5 5 3 3 3
3 6 3 6 3 6 3 6 3 6 3 6 3 6 3
2 3 3 3 3 3 3 3 3 3 3 2 3 3 3
2 6 6 6 6 3 6 6 6 3 6 6 6 6 3
2 3 3 3 3 3 3 3 3 2 3 2 3 3 3
2 6 3 6 3 6 3 6 3 6 3 6 3 6 3
2 3 3 3 3 3 3 3 3 2 3 2 3 3 3
3 6 3 6 3 6 3 6 3 6 3 6 3 6 3
3 3 3 2 3 3 3 3 3 2 3 2 3 3 3
3 6 3 6 3 6 3 6 3 6 3 6 3 6 3
3 3 3 3 3 3 3 3 3 2 3 2 3 3 3
3 6 3 6 3 6 3 6 3 6 3 6 3 6 1
3 3 3 3 3 3 3 3 3 2 3 2 3 3 5