15 19
0 3 3 5 5 3 3 3 5 3 5 5 5 3 3
3 6 5 6 3 6 5 6 3 6 3 6 3 6 3
3 5 5 5 5 5 5 5 5 5 3 5 5 5 5
3 6 5 6 3 6 5 6 5 6 5 6 5 6 5
5 3 3 3 5 5 5 5 3 3 5 5 3 3 3
5 6 5 6 5 6 5 6 5 6 5 6 5 6 5
3 5 3 5 5 5 5 5 5 5 5 5 3 3 5
3 6 3 6 3 6 3 6 5 6 5 6 5 6 3
3 3 3 5 5 3 3 3 5 5 5 3 5 3 3
6 6 6 3 6 3 6 3 6 3 6 3 6 6 6
3 3 5 5 3 5 5 5 5 5 5 5 5 3 3
3 6 5 6 5 6 5 6 5 6 5 6 5 6 3
5 3 3 3 5 3 5 5 5 5 5 5 3 5 3
3 6 5 6 5 6 5 6 5 6 5 6 5 6 5
3 5 5 5 3 3 5 3 5 5 3 5 3 5 3
3 6 5 6 5 6 5 6 3 6 3 6 3 6 5
3 5 5 5 5 5 3 5 5 5 3 5 3 5 5
3 6 3 6 3 6 5 6 5 6 5 6 5 6 3
3 3 5 5 5 3 5 5 3 5 5 5 5 3 1